xxxxxxxxxx
x--------x
x---x----x
x---x----x
x---xxx--x
x-----x--x
x-----x--x
x--------x
x--------x
xxxxxxxxxx